jQuery هو إطار عمل js مشهور يساعد في تسهيل كتابة DOM في js و من أجل البدأ نقوم بتضمين ملف jquery-3.7.0.js في صفحة html ثم نكتب في ملف js:
$(document).ready(function(){
هنا نكتب أكواد jQuery.
});
طريقة عملها نقوم بالاستعلام عن عنصر ثم نضيف له خاصية على شكل دالة:
$("div").addClass("header")
في هذا الكود احضرنا كل عناصر div ثم أضفنا لهم كلهم كلاس باسم header.
يمكن استعمال المتغيرات دون استعمال الكلمة المفتاحية var.
من وظائفها:
addClass(): لإضافة كلاس للعنصر.
removeClass(): لإزالة كلاس لعنصر.
click(): عند الضغط على زر.
dblclick(): عند الضغط ضغطة مزدوجة.
mouseenter(): عند مرور الماوس فوق العنصر.
mouseleave(): عند خروج الماوس من العنصر.
animate(): لنقل العاصر من موقعها.
hide(): الإخفاء و تقبل كقيمة المدة الزمنية للإخفاء بالميليثانية.
show(): الإظهار مثل سابقه في القيمة.
fadeIn(): إظهار بتدرج و مثل سابقه في القيمة
fadeOut(): إخفاء بتدرج و مثل سابقه في القيمة.
slideUp(): إظهار كالستار و مثل السابق في القيمة.
slideDown(): إخفاء كالستار و مثل السابق في القيمة.
toggle(): نقرة تظهر نقرة أخرى يختفي مثل السابق في القيمة.
slideToggle():بنقرة يظهر كالستار و نقرة اخرة يختفي كالستار و مثل سابقه في القيمة.
slideFade(): بنقرة يظهر بتدرج و نقرة أخرى للإخفاء بتدريج و مثل سابقه في القيمة.
css(): للتعديل في خصائص css لهذا العنصر.
prop(): للتعديل في خصائص العنصر.
html(): تغير النص و الترميز دالخ عنصر.
text(): تغير النص فقط دون مراعات الترميز.
remove(): لحذف عنصر تماما.
appendTo(): إضافة عنصر داخل عنصر آخر.
clone(): ينشأ نسخة من عنصر و يجب إلحاقه بالدالة appendTo() من أجل معرفة أين سيوضع هه النسخة.
parent(): للوصول للعنصر الأب لعنصر.
children(): للوصول لعناصر الأبناء لعنصر.
طرق للإستعلام عن عنصر:
:nth-child(): الوصول للإبن المحدد.
:even: للوصول لكل العناصر الزوجية.
:odd: للوصول لكل العناصر الفردية.






